170	10	500
Rome.InGame.CribSheet_Camera_Title
Rome.InGame.CribSheet_Pan_Title	Rome.InGame.CribSheet_Pan_BattleText
Rome.InGame.CribSheet_Rotate_Title	Rome.InGame.CribSheet_Rotate_Text
Rome.InGame.CribSheet_Zoom_Title	Rome.InGame.CribSheet_Zoom_BattleText
Rome.InGame.CribSheet_FocusUnit_Title	Rome.InGame.CribSheet_FocusUnit_Text
Rome.InGame.CribSheet_FocusPoint_Title	Rome.InGame.CribSheet_FocusPoint_Text
Rome.InGame.CribSheet_FocusGeneral_Title	Rome.InGame.CribSheet_FocusGeneral_Text

Rome.InGame.CribSheet_UI_Title
Rome.InGame.CribSheet_Tooltips_Title	Rome.InGame.CribSheet_Tooltips_Text
Rome.InGame.CribSheet_PauseBattle_Title	Rome.InGame.CribSheet_PauseBattle_Body
Rome.InGame.CribSheet_UnitOrder_Title	Rome.InGame.CribSheet_UnitOrder_Text
Rome.InGame.CribSheet_Formations_Title	Rome.InGame.CribSheet_Formations_Text	67	8
Rome.InGame.CribSheet_GeneralOrder_Title	Rome.InGame.CribSheet_GeneralOrder_Text
Rome.InGame.CribSheet_Pause_Title	Rome.InGame.CribSheet_Pause_Text
Rome.InGame.CribSheet_ViewHelp_Title	Rome.InGame.CribSheet_ViewHelp_Text	-1	-1
Rome.InGame.CribSheet_DismissHelp_Title	Rome.InGame.CribSheet_DismissHelp_Text	148
Rome.InGame.CribSheet_ShowMe_Title	Rome.InGame.CribSheet_ShowMe_Text	222
Rome.InGame.CribSheet_Locate_Title	Rome.InGame.CribSheet_Locate_Text	135
Rome.InGame.CribSheet_Map_Title	Rome.InGame.CribSheet_Map_Text	264	1	no_border
Rome.InGame.CribSheet_SelectUnit_Title	Rome.InGame.CribSheet_SelectUnit_Text
Rome.InGame.CribSheet_DeselectUnit_Title	Rome.InGame.CribSheet_DeselectUnit_Text
Rome.InGame.CribSheet_SelectMultiUnit_Title	Rome.InGame.CribSheet_SelectMultiUnit_Text
Rome.InGame.CribSheet_DeselectMultiUnit_Title	Rome.InGame.CribSheet_DeselectMultiUnit_Text
Rome.InGame.CribSheet_SelectDeselectAllUnits_Title	Rome.InGame.CribSheet_SelectDeselectAllUnits_Text	293	1	no_border
Rome.InGame.CribSheet_DrawPath_Title	Rome.InGame.CribSheet_DrawPath_Text
Rome.InGame.CribSheet_ConfirmMove_Title	Rome.InGame.CribSheet_ConfirmMove_Text	147
Rome.InGame.CribSheet_CancelMove_Title	Rome.InGame.CribSheet_CancelMove_Text
Rome.InGame.CribSheet_MoveUnit_Title	Rome.InGame.CribSheet_MoveUnit_Text
Rome.InGame.CribSheet_AttackUnit_Title	Rome.InGame.CribSheet_AttackUnit_Text
Rome.InGame.CribSheet_ConfirmPrimary_Title	Rome.InGame.CribSheet_ConfirmPrimary_Text	131	8
Rome.InGame.CribSheet_ConfirmSecondary_Title	Rome.InGame.CribSheet_ConfirmSecondary_Text	132	8
Rome.InGame.CribSheet_AttackEnemy_Title	Rome.InGame.CribSheet_AttackEnemy_Text
Rome.InGame.CribSheet_ChangeFormation_Title	Rome.InGame.CribSheet_ChangeFormation_Text
Rome.InGame.CribSheet_ChangeDirection_Title	Rome.InGame.CribSheet_ChangeDirection_Text
